DEEEEEEE
WWWWWWWE
EEEEEEWE
EWEEAEWE
EWEEWEWE
EWEEEEWE
EWWWWWWE
EEEEEEEE